5
-100   16  200 100   0 255   0 0
 116   16   64  16   0   0 255 0
 164  -16   16  32   0   0 255 0
 196  -16   48  16 255   0   0 0
 300  -16   64  32   0 255   0 0

1
100 -60

430 32

1
500 -100


