12
-16   0  16  16  255   0 0 0
 64   0  16  16  255   0 0 0
 96   0  16  16  255   0 0 0
176   0  16  16  255   0 0 0
208   0  16  16  255   0 0 0
288   0  16  16  255   0 0 0
320   0  16  16  255   0 0 0
400   0  16  16  255   0 0 0
-16  16  96  16    0 255 0 0
 96  16  96  16    0 255 0 0
208  16  96  16    0 255 0 0
320  16  96  16    0 255 0 0

4
48 0
160 0
272 0
384 0

432 0

9
160 0
160 0
160 0
272 0
272 0
272 0
384 0
384 0
384 0