32
  0  16  8 80  16  16  16 0
 32  16  8 80  32  32  32 0
 64  16  8 80  48  48  48 0
 96  16  8 80  64  64  64 0
128  16  8 80  80  80  80 0
160  16  8 80  96  96  96 0
192  16  8 80 112 112 112 0
224  16  8 80 128 128 128 0
256  16  8 80 144 144 144 0
288  16  8 80 160 160 160 0
320  16  8 80 176 176 176 0
352  16  8 80 192 192 192 0
384  16  8 80 208 208 208 0
416  16  8 80 224 224 224 0
448  16  8 80 240 240 240 0
480  16  8 80 255 255 255 0
512  16  8 80  16  16  16 0
544  16  8 80  32  32  32 0
576  16  8 80  48  48  48 0
608  16  8 80  64  64  64 0
640  16  8 80  80  80  80 0
672  16  8 80  96  96  96 0
704  16  8 80 112 112 112 0
736  16  8 80 128 128 128 0
768  16  8 80 144 144 144 0
800  16  8 80 160 160 160 0
832  16  8 80 176 176 176 0
864  16  8 80 192 192 192 0
896  16  8 80 208 208 208 0
928  16  8 80 224 224 224 0
960  16  8 80 240 240 240 0
992  16  8 80 255 255 255 0

8
96 0
224 0
352 0
480 0
608 0
736 0
864 0
992 0

1024 16

1
10000 -100