5
-100   16  300 100   0 255 255 0
 216   16   64  16 255   0 255 0
 264  -16   16  32   0 255   0 0
 296  -16   48  16 255   0   0 0
 400  -16   64  32   0   0 255 0

1
180 -60

430 -32

1
190 0