5
-100   16  600 100   0 255   0 0
 516   16   64  16   0   0 255 0
 564  -16   16  32   0   0 255 0
 596  -16   48  16 255   0   0 0
 700  -16   64  32   0 255   0 0

5
100 -48
200 0
250 0
300 0
360 0

830 32

5
350 0
350 -16
500 0
500 -32
500 -32
