16
  0  16  16 80  16  16  16 0
 32  16  16 80  32  32  32 0
 64  16  16 80  48  48  48 0
 96  16  16 80  64  64  64 0
128  16  16 80  80  80  80 0
160  16  16 80  96  96  96 0
192  16  16 80 112 112 112 0
224  16  16 80 128 128 128 0
256  16  16 80 144 144 144 0
288  16  16 80 160 160 160 0
320  16  16 80 176 176 176 0
352  16  16 80 192 192 192 0
384  16  16 80 208 208 208 0
416  16  16 80 224 224 224 0
448  16  16 80 240 240 240 0
480  16  16 80 255 255 255 0

4
96 0
224 0
352 0
480 0

512 16

1
1000 -100