8
  0 16 32 16  0 0 0 0
132 16 32 16  31 0 0 0
248 16 32 16  63 0 0 0
364 16 32 16  95 0 0 0
480 16 32 16 127 0 0 0
596 16 32 16 159 0 0 0
712 16 32 16 191 0 0 0
844 16 32 16 223 0 0 0

4
116 0
348 0
580 0
812 0

960 0

1
10000 0